####################
#S.................#
#....A.............#
#..............C...#
#.......B..........#
#F.............D...#
#.............###.##
#......E......#...H#
####################